[
   {
      "504605" : 100,
      "504905" : 100,
      "505005" : 100,
      "unban_lvl_whole" : 18
   },
   {
      "504605" : 100,
      "504905" : 100,
      "505005" : 100,
      "unban_lvl_whole" : 24
   },
   {
      "504605" : 100,
      "504905" : 100,
      "505005" : 100,
      "unban_lvl_whole" : 30
   },
   {
      "504605" : 100,
      "504905" : 100,
      "505005" : 100,
      "unban_lvl_whole" : 36
   }
]
